2 2 2 2 2 2 2 2 2 2 2 2 2 2 2 2 2 2 2 2 2 2 2 2 2 2 2 2 2 2 2 2 2 2 2 2 2 2 2 2 2 2 2 2 2 2 2 2 2 2
2 2 2 2 2 2 2 2 2 2 2 2 2 2 2 2 2 2 2 2 2 2 2 2 2 2 2 2 2 2 2 2 2 2 2 2 2 2 2 2 2 2 2 2 2 2 2 2 2 2
2 2 2 2 24 26 26 26 26 25 2 2 2 2 2 2 2 24 26 26 26 26 26 26 26 26 26 26 25 2 2 2 2 2 2 2 2 24 26 26 26 26 26 26 26 26 25 2 2 2
2 2 2 24 3 3 3 3 3 3 25 2 2 2 2 2 24 3 3 3 3 3 3 3 3 3 3 3 3 25 2 2 2 2 2 2 24 3 3 3 3 3 3 3 3 3 3 25 2 2
2 2 24 3 3 3 3 3 3 3 3 26 26 26 26 26 3 3 3 3 3 3 3 3 3 3 3 3 3 3 25 2 2 2 2 24 3 3 3 3 3 3 3 3 3 3 3 23 2 2
2 2 22 3 3 3 29 34 32 3 3 3 3 3 3 3 3 3 29 34 34 34 34 34 34 34 34 34 32 3 3 26 26 26 26 3 29 34 34 34 34 34 34 34 32 3 3 23 2 2
2 2 22 3 3 29 1 1 1 32 3 3 3 3 3 3 3 29 1 4 4 4 4 4 4 35 4 4 1 34 32 3 3 3 3 29 1 4 4 4 35 4 4 4 33 3 3 23 2 2
2 2 22 3 3 30 1 35 4 1 34 34 34 34 34 34 34 1 4 4 4 4 4 4 4 4 4 4 4 4 1 34 34 34 34 1 4 4 1 1 1 1 4 4 33 3 3 23 2 2
2 2 22 3 3 30 1 4 4 4 4 4 4 4 4 4 4 4 4 1 1 1 1 1 1 1 1 1 1 1 4 4 4 4 35 4 4 1 1 1 1 1 4 4 33 3 3 20 2 2
2 2 22 3 3 30 1 4 4 35 1 1 1 1 1 1 1 1 1 1 1 1 1 1 1 1 1 1 1 1 1 1 1 1 1 1 1 1 1 1 1 1 4 1 31 3 20 2 2 2
2 2 22 3 3 30 1 4 4 1 1 14 11 9 9 9 9 9 9 11 9 9 9 9 9 9 9 9 9 9 9 9 9 9 9 9 9 9 9 11 16 4 4 33 3 23 2 2 2 2
2 2 22 3 3 30 1 4 4 1 1 12 17 1 1 1 1 1 1 18 4 4 4 4 35 4 4 4 4 4 4 4 4 4 4 4 4 4 4 12 13 4 4 33 3 23 2 2 2 2
2 2 22 3 3 30 1 4 4 1 1 18 1 1 1 1 4 4 4 18 4 4 4 4 4 4 4 4 4 4 4 4 4 4 4 35 4 4 4 12 13 4 4 33 3 23 2 2 2 2
2 2 22 3 3 30 1 4 4 1 1 18 1 1 4 4 4 4 4 18 4 4 4 4 4 4 4 4 35 4 4 4 4 4 4 4 4 4 4 12 13 4 4 33 3 3 25 2 2 2
2 2 22 3 3 30 1 4 4 4 1 18 1 4 4 4 4 4 4 18 4 4 4 4 4 4 4 4 4 4 4 4 4 4 4 4 4 4 4 12 13 4 4 1 32 3 3 25 2 2
2 2 22 3 3 30 1 4 4 4 1 18 4 4 4 4 4 4 35 18 4 4 35 4 4 4 4 4 4 4 4 4 4 4 4 4 4 4 4 15 13 1 35 4 33 3 3 23 2 2
2 2 22 3 3 30 1 35 4 4 4 18 4 4 4 4 4 4 4 18 4 4 4 4 4 4 4 4 4 4 4 4 4 4 4 4 4 4 4 4 18 1 4 4 33 3 3 23 2 2
2 2 22 3 3 30 1 4 4 4 35 18 4 4 4 35 4 4 4 12 16 35 4 4 4 4 4 35 4 4 4 4 4 4 4 4 4 4 4 4 18 1 4 4 33 3 3 23 2 2
2 2 22 3 3 30 1 4 4 4 4 18 4 4 4 4 4 4 14 0 0 11 11 11 11 11 11 11 16 4 4 4 4 4 4 4 4 4 4 4 18 1 35 4 33 3 3 23 2 2
2 2 22 3 3 30 1 4 4 4 4 18 4 4 4 4 4 4 12 6 0 8 8 8 8 8 8 7 13 4 35 4 4 4 4 4 4 4 4 4 18 1 4 4 33 3 3 23 2 2
2 2 22 3 3 30 1 4 4 4 4 18 35 4 4 4 35 4 12 6 5 5 5 5 5 5 5 7 13 4 4 4 4 4 4 4 4 4 4 4 18 1 4 35 33 3 3 23 2 2
2 2 19 3 3 28 1 1 35 4 4 18 4 4 4 4 4 4 12 6 5 5 5 5 5 5 5 7 13 4 4 4 4 4 4 4 4 4 4 4 18 1 4 4 33 3 3 23 2 2
2 2 2 19 3 3 28 1 1 4 4 18 4 4 4 4 4 4 12 6 5 5 5 5 5 5 5 7 13 35 4 4 4 4 4 4 4 4 4 4 18 1 4 4 33 3 3 23 2 2
2 2 2 2 22 3 3 30 1 4 4 18 4 4 4 4 4 4 12 6 5 5 5 5 5 5 5 7 13 4 35 4 4 4 4 4 4 4 4 4 18 1 4 4 33 3 3 23 2 2
2 2 2 2 22 3 3 30 1 4 4 18 4 4 4 4 4 4 12 6 8 8 8 8 8 8 0 7 13 4 4 4 4 4 4 4 4 4 4 1 18 1 35 4 33 3 3 23 2 2
2 2 2 24 3 3 29 1 4 35 1 18 4 4 4 35 4 4 15 10 10 10 10 10 10 10 0 10 17 4 4 4 4 4 4 4 4 4 4 1 18 1 4 4 33 3 3 20 2 2
2 2 24 3 3 29 1 1 4 4 1 18 1 4 4 4 4 35 4 4 4 4 4 4 4 1 18 1 4 4 4 4 4 4 4 4 4 4 4 1 18 1 4 4 33 3 23 2 2 2
2 2 22 3 3 30 1 35 4 1 14 17 1 4 4 4 4 4 4 4 4 35 4 4 4 1 18 1 4 4 4 4 4 4 4 4 4 1 1 14 17 1 4 4 33 3 23 2 2 2
2 2 22 3 3 30 1 4 4 1 18 1 1 4 4 4 4 4 4 4 4 4 4 4 4 1 18 1 4 4 4 4 4 4 4 4 4 1 14 13 1 35 4 1 31 3 20 2 2 2
2 2 22 3 3 30 1 4 4 1 18 1 4 4 4 4 4 4 4 4 4 4 4 4 4 1 18 1 4 4 4 4 4 4 4 4 4 1 12 13 4 4 1 31 3 20 2 2 2 2
2 2 22 3 3 30 1 4 4 1 18 1 4 4 4 4 4 4 4 4 4 4 4 4 4 1 18 1 4 4 4 4 4 4 4 4 4 1 12 13 4 4 33 3 23 2 2 2 2 2
2 2 22 3 3 30 1 4 4 1 18 1 4 4 4 4 4 4 4 4 4 4 4 4 4 1 18 1 4 4 4 4 4 4 4 4 4 1 12 13 4 4 33 3 23 2 2 2 2 2
2 2 22 3 3 30 1 4 4 1 18 1 4 4 4 4 4 4 4 4 4 4 4 4 4 1 18 1 4 4 4 4 4 4 4 4 4 1 12 13 4 35 33 3 3 25 2 2 2 2
2 2 22 3 3 30 1 35 4 1 18 1 4 4 4 1 1 1 1 4 4 4 4 4 4 1 18 1 35 4 4 4 4 4 4 4 1 1 12 17 4 4 1 32 3 3 25 2 2 2
2 2 22 3 3 30 1 4 4 1 18 1 4 4 4 1 14 11 16 4 4 4 4 4 4 1 18 1 4 4 4 4 4 4 4 4 1 14 17 1 4 4 4 1 32 3 3 25 2 2
2 2 19 3 3 28 1 4 4 1 18 1 1 1 1 1 12 0 13 4 4 4 4 4 4 1 18 1 4 4 4 4 4 4 4 4 1 18 1 1 4 4 4 4 33 3 3 23 2 2
2 2 2 22 3 3 30 1 4 35 12 11 11 11 11 11 0 0 13 4 4 4 4 4 4 1 18 1 1 4 4 4 4 4 35 4 1 18 1 4 4 4 4 4 33 3 3 23 2 2
2 2 2 19 3 3 28 1 1 4 12 0 0 0 0 0 0 0 13 4 4 35 4 4 4 1 18 1 1 1 1 1 1 1 1 1 1 18 1 1 1 4 4 4 33 3 3 23 2 2
2 2 2 2 22 3 3 30 1 4 12 0 0 0 0 0 0 0 13 4 4 4 4 4 4 1 18 1 1 1 1 1 1 1 1 1 1 18 1 1 1 4 4 4 33 3 3 23 2 2
2 2 2 2 22 3 3 30 1 4 15 0 0 0 0 0 0 0 13 4 4 4 35 4 4 1 15 9 9 9 9 9 9 9 11 36 36 36 36 36 36 4 35 4 33 3 3 23 2 2
2 2 2 24 3 3 29 1 1 4 4 15 10 10 10 10 10 10 17 4 4 4 4 4 4 1 1 1 1 1 1 1 1 1 12 37 37 37 37 37 36 4 4 35 33 3 3 23 2 2
2 2 24 3 3 29 1 1 35 4 4 4 4 4 4 4 4 4 35 4 4 4 4 4 4 35 4 4 4 4 4 4 4 1 36 37 37 37 37 37 36 4 4 4 33 3 3 23 2 2
2 2 22 3 3 30 1 4 4 4 4 4 4 35 4 4 4 4 4 4 4 4 4 4 4 4 4 4 4 4 4 4 4 4 36 37 37 37 37 37 36 4 4 4 33 3 3 23 2 2
2 2 22 3 3 30 1 1 4 4 1 27 27 27 27 27 1 1 4 4 4 4 4 4 4 4 4 1 27 27 27 1 4 4 36 36 36 36 36 36 36 4 4 4 33 3 3 23 2 2
2 2 22 3 3 28 27 27 27 27 31 3 3 3 3 3 28 1 4 35 4 4 4 4 4 4 1 31 3 3 3 28 1 35 4 4 4 4 4 4 4 4 4 4 33 3 3 23 2 2
2 2 22 3 3 3 3 3 3 3 3 21 21 21 21 21 3 28 27 27 27 27 27 27 27 27 31 3 21 21 21 3 28 27 27 27 27 27 27 27 27 27 27 27 31 3 3 23 2 2
2 2 22 3 3 3 3 3 3 3 20 2 2 2 2 2 19 3 3 3 3 3 3 3 3 3 3 20 2 2 2 19 3 3 3 3 3 3 3 3 3 3 3 3 3 3 3 23 2 2
2 2 19 21 21 21 21 21 21 20 2 2 2 2 2 2 2 19 21 21 21 21 21 21 21 21 20 2 2 2 2 2 19 21 21 21 21 21 21 21 21 21 21 21 21 21 21 20 2 2
2 2 2 2 2 2 2 2 2 2 2 2 2 2 2 2 2 2 2 2 2 2 2 2 2 2 2 2 2 2 2 2 2 2 2 2 2 2 2 2 2 2 2 2 2 2 2 2 2 2
2 2 2 2 2 2 2 2 2 2 2 2 2 2 2 2 2 2 2 2 2 2 2 2 2 2 2 2 2 2 2 2 2 2 2 2 2 2 2 2 2 2 2 2 2 2 2 2 2 2